date,amount,,,type,description,balance,category
16-Aug-14,-9.8,,,EFTPOS DEBIT,,1046.19,
16-Aug-14,-29,,,EFTPOS DEBIT,,1055.99,fun
16-Aug-14,-30.13,,,EFTPOS DEBIT,,1084.99,groceries
16-Aug-14,-33.98,,,MISCELLANEOUS DEBIT,OUTSTANDING TRANS   #1234-56789-9876-1234,1115.12,groceries
15-Aug-14,-13.39,,,MISCELLANEOUS DEBIT,V1234 14/08 WOOLWORTHS1073           DICKSON    04235432672,1149.1,groceries
15-Aug-14,-62.87,,,MISCELLANEOUS DEBIT,V1234 13/08 SUPABARN CITY            CANBERRA   12345678901,1162.49,groceries
15-Aug-14,-306,,,TRANSFER DEBIT,INTERNET TRANSFER   electricity         mj,1225.36,electricity
15-Aug-14,-6.68,,,EFTPOS DEBIT,EFTPOS 15/08 19:03  LYNEHAM SUPERMARKET,1531.36,groceries
14-Aug-14,-17.52,,,MISCELLANEOUS DEBIT,V1234 13/08 ALDI                     CANBERRA   03193719249,1538.04,groceries
14-Aug-14,-12,,,MISCELLANEOUS DEBIT,V1234 14/08 Uni House 6              Aust Nat U 12345678901,1555.56,eat
14-Aug-14,-12.9,,,MISCELLANEOUS DEBIT,V1234 13/08 EVERYDAY FOOD PTY LTD    ACTON      12345678901,1567.56,eat
13-Aug-14,1241.87,,,SALARY,4666424             ANU,1580.46,salary
11-Aug-14,331.22,,,INTER-BANK CREDIT,7E1K2074208553998K  CTRLINK YTH ALL,338.59,centrelink
11-Aug-14,-78.78,,,MISCELLANEOUS DEBIT,V1234 10/08 COLES EXPR  WILLOUGHBY   NSW        12345674221,7.37,fuel
11-Aug-14,-28.27,,,MISCELLANEOUS DEBIT,V1234 10/08 ALDI                     CANBERRA   07190782657,86.15,groceries
11-Aug-14,-13.7,,,MISCELLANEOUS DEBIT,V1234 09/08 WOOLWORTHS1099           ST IVES    06130006702,114.42,groceries
11-Aug-14,-50,,,MISCELLANEOUS DEBIT,V1234 09/08 ROAM TOLLING P/L         MELBOURNE  74940524221,128.12,car
11-Aug-14,-68.37,,,MISCELLANEOUS DEBIT,V1234 09/08 HFM ST IVES              ST IVES    74940524221,178.12,groceries
11-Aug-14,-9.02,,,MISCELLANEOUS DEBIT,V1234 08/08 HFM MANLY                MANLY      74940524220,246.49,groceries
11-Aug-14,-1000,,,TRANSFER DEBIT,INTERNET TRANSFER   save,255.51,transfer
08-Aug-14,-7,,,MISCELLANEOUS DEBIT,V1234 08/08 COLES  MANLY CORSO       NSW        12345674220,1255.51,eat
08-Aug-14,-21.15,,,EFTPOS DEBIT,EFTPOS 08/08 18:18  PIZZA CAPANNA,1262.51,eat
07-Aug-14,-4.02,,,MISCELLANEOUS DEBIT,V1234 07/08 MAJESTIC FRESH           CANBERRA   04174112608,1283.66,groceries
07-Aug-14,-24.58,,,MISCELLANEOUS DEBIT,V1234 07/08 ALDI                     CANBERRA   04174093047,1287.68,groceries
06-Aug-14,800,,,TRANSFER CREDIT,INTERNET TRANSFER   Rent                R and J,1312.26,parents
05-Aug-14,-0.34,,,FEES,V1234 03/08 FOREIGN CURRENCY TRAN FEE           24692164215,512.26,work
04-Aug-14,-5.99,,,MISCELLANEOUS DEBIT,V1234 31/07 SUPABARN CITY            CANBERRA   74564454213,512.6,groceries
04-Aug-14,-11.24,,,MISCELLANEOUS DEBIT,V1234 03/08 Amazon Web Services      aws.amazon 24692164215,518.59,work
04-Aug-14,-30.86,,,MISCELLANEOUS DEBIT,V1234 02/08 ALDI                     CANBERRA   06110273914,529.83,groceries
01-Aug-14,-24.88,,,MISCELLANEOUS DEBIT,V1234 31/07 ALDI                     CANBERRA   04090037345,560.69,groceries
01-Aug-14,-5.78,,,MISCELLANEOUS DEBIT,V1234 01/08 WOOLWORTHS1073           DICKSON    05175604815,585.57,groceries
31-Jul-14,-6,,,MISCELLANEOUS DEBIT,V1234 31/07 BIG W 122                CANBERRA C 04094290340,591.35,education
31-Jul-14,-50,,,TRANSFER DEBIT,INTERNET TRANSFER   asher disc,597.35,fun
30-Jul-14,-2000,,,TRANSFER DEBIT,INTERNET TRANSFER   RENT,-594.52,rent
30-Jul-14,1241.87,,,SALARY,,2647.35,salary
29-Jul-14,-57.38,,,MISCELLANEOUS DEBIT,V1234 28/07 ALDI 50                  BELCONNEN  01195066599,1405.48,groceries
29-Jul-14,-20,,,ATM DEBIT,BBL ATM    29th13:20SHOP T1 T2 & T3 Grou,1462.86,eat
28-Jul-14,1356.22,,,INTER-BANK CREDIT,7E1K1694208553998K  CTRLINK YTH ALL,1482.86,centrelink
28-Jul-14,-10,,,MISCELLANEOUS DEBIT,V1234 28/07 COLES  BELCONNEN         ACT        12345674209,126.64,groceries
28-Jul-14,-36.9,,,MISCELLANEOUS DEBIT,V1234 26/07 WOW 1441 WAGGA           WAGGA WAGG 06110667932,136.64,gifts
28-Jul-14,-12.99,,,MISCELLANEOUS DEBIT,V1234 24/07 QBD THE BOOKSHOP         CANBERRA   74940524206,173.54,gifts
28-Jul-14,-58,,,MISCELLANEOUS DEBIT,V1234 26/07 MURRAYS AUSTRALIA LIMITEDRED HILL   74564454209,186.53,transport
28-Jul-14,-41.2,,,EFTPOS DEBIT,EFTPOS 27/07 10:28  MAYA FOOD HOLDINGS P,244.53,gifts
25-Jul-14,-19.95,,,MISCELLANEOUS DEBIT,V1234 23/07 ECKERSLEYS BRA           BRADDON    74564724205,285.73,fun
25-Jul-14,-65,,,TRANSFER DEBIT,INTERNET TRANSFER   jacq asher book,305.68,education
24-Jul-14,-12.97,,,MISCELLANEOUS DEBIT,V1234 24/07 WOOLWORTHS1073           DICKSON    04183912967,370.68,groceries
24-Jul-14,-19.82,,,MISCELLANEOUS DEBIT,V1234 24/07 ALDI                     CANBERRA   04153817907,383.65,groceries
24-Jul-14,-10.68,,,MISCELLANEOUS DEBIT,V1234 23/07 WOOLWORTHS1073           DICKSON    03210577125,403.47,groceries
23-Jul-14,-81,,,AUTOMATIC DRAWING,2000410934887       Telstra DDebit,414.15,mobile
23-Jul-14,0.1,,,INTER-BANK CREDIT,5HSDDTKG792CL       PAYPAL AUSTRALIA,495.15,work
23-Jul-14,0.12,,,INTER-BANK CREDIT,5HS7PWSXPY2CL       PAYPAL AUSTRALIA,495.05,work
23-Jul-14,-5.97,,,MISCELLANEOUS DEBIT,V1234 22/07 WOOLWORTHS1073           DICKSON    02194509324,494.93,groceries
23-Jul-14,-1,,,MISCELLANEOUS DEBIT,V1234 21/07 HOYTS KIOSK PTY LTD      SYDNEY     74564454203,500.9,fun
21-Jul-14,-82.58,,,MISCELLANEOUS DEBIT,V1234 18/07 CALTEX                   YASS       74940524200,501.9,fuel
21-Jul-14,-14.79,,,MISCELLANEOUS DEBIT,V1234 21/07 WOOLWORTHS1073           DICKSON    01143134672,584.48,groceries
21-Jul-14,-22.25,,,MISCELLANEOUS DEBIT,V1234 20/07 ALDI                     CANBERRA   07115572514,599.27,groceries
21-Jul-14,-2.5,,,MISCELLANEOUS DEBIT,V1234 20/07 ALDI                     CANBERRA   07115573565,621.52,groceries
21-Jul-14,-22.66,,,MISCELLANEOUS DEBIT,V1234 18/07 WOOLWORTHS1073           DICKSON    05220719816,624.02,groceries
21-Jul-14,-0.74,,,FEES,V1234 17/07 FOREIGN CURRENCY TRAN FEE           24692164198,646.68,work
21-Jul-14,-4.99,,,EFTPOS DEBIT,EFTPOS 19/07 13:24  LYNEHAM SUPERMARKET,647.42,groceries
18-Jul-14,-24.7,,,MISCELLANEOUS DEBIT,V1234 17/07 Amazon Web Services      aws.amazon 24692164198,652.41,work
18-Jul-14,-1000,,,TRANSFER DEBIT,INTERNET TRANSFER   save,677.11,transfer
16-Jul-14,1241.87,,,SALARY,4666424             ANU,1677.11,salary
16-Jul-14,-140.5,,,MISCELLANEOUS DEBIT,V1234 16/07 ANU                      CANBERRA   03114199305,435.24,education
15-Jul-14,-17.89,,,MISCELLANEOUS DEBIT,V1234 15/07 WOOLWORTHS1073           DICKSON    02175825951,575.74,groceries
15-Jul-14,-5.07,,,MISCELLANEOUS DEBIT,V1234 14/07 GO TROPPO FRUIT MARK     MACQUARIE  74940524195,593.63,groceries
15-Jul-14,-63.02,,,MISCELLANEOUS DEBIT,V1234 14/07 ALDI                     MACQUARIE  01130312222,598.7,groceries
15-Jul-14,-7,,,MISCELLANEOUS DEBIT,V1234 11/07 MCDONALDS THORNLEIGH     THORNLEIGH 74564724195,661.72,eat
14-Jul-14,331.22,,,INTER-BANK CREDIT,7E1K1314208553998K  CTRLINK YTH ALL,668.72,centrelink
14-Jul-14,-21.74,,,MISCELLANEOUS DEBIT,V1234 14/07 WOOLWORTHS1073           DICKSON    01165260948,337.5,groceries
14-Jul-14,-3,,,MISCELLANEOUS DEBIT,V1234 14/07 COLES  JAMISON CENTRE    ACT        12345674195,359.24,groceries
14-Jul-14,-23.95,,,MISCELLANEOUS DEBIT,V1234 13/07 WOOLWORTHS1073           DICKSON    07205242894,362.24,groceries
14-Jul-14,-13.5,,,MISCELLANEOUS DEBIT,V1234 13/07 ESTABAR                  NEWCASTLE  07131842181,386.19,eat
11-Jul-14,-31,,,MISCELLANEOUS DEBIT,V1234 11/07 KMART  KOTARA            NSW        12345674192,399.69,clothes
11-Jul-14,-46.16,,,MISCELLANEOUS DEBIT,V1234 10/07 MYER  CANBERRA CITY      CANBERRA   74564454191,430.69,household
11-Jul-14,-10.31,,,MISCELLANEOUS DEBIT,V1234 10/07 ALDI                     CANBERRA   04124594916,476.85,groceries
11-Jul-14,-16.95,,,MISCELLANEOUS DEBIT,V1234 11/07 WOOLWORTHS 1207          KOTARA     05170173236,487.16,groceries
11-Jul-14,-56.47,,,MISCELLANEOUS DEBIT,V1234 11/07 COLES  KOTARA            NSW        12345674192,504.11,groceries
11-Jul-14,-7.5,,,EFTPOS DEBIT,EFTPOS 10/07 10:15  CANBERRA TEA CENTRE\,560.58,groceries
11-Jul-14,-28.95,,,EFTPOS DEBIT,EFTPOS 11/07 17:28  THE ESSENTIAL INGRED,568.08,gifts
10-Jul-14,-5000,,,TRANSFER DEBIT,INTERNET TRANSFER   firsthome,597.03,transfer
10-Jul-14,5143.72,,,TRANSFER CREDIT,INTERNET TRANSFER   unsave              mj,5597.03,transfer
10-Jul-14,-25,,,EFTPOS DEBIT,EFTPOS 10/07 12:29  ELEGANT PEARLS AND J,453.31,gifts
09-Jul-14,-15.26,,,MISCELLANEOUS DEBIT,V1234 08/07 ALDI                     MACQUARIE  02111917355,478.31,groceries
08-Jul-14,-9.8,,,MISCELLANEOUS DEBIT,V1234 08/07 WOOLWORTHS1073           DICKSON    02165064696,493.57,groceries
08-Jul-14,-13.09,,,MISCELLANEOUS DEBIT,V1234 07/07 WOOLWORTHS1073           DICKSON    01185497986,503.37,groceries
08-Jul-14,-22.2,,,MISCELLANEOUS DEBIT,V1234 07/07 Good Brother             Dickson    74564564188,516.46,eat
08-Jul-14,-10.27,,,EFTPOS DEBIT,EFTPOS 08/07 10:33  SIMCO FRESH MEATS,538.66,groceries
07-Jul-14,-28.89,,,MISCELLANEOUS DEBIT,V1234 07/07 WOOLWORTHS1073           DICKSON    01140641897,548.93,groceries
07-Jul-14,-45.93,,,MISCELLANEOUS DEBIT,V1234 06/07 WOOLWORTHS1099           ST IVES    07102076777,577.82,groceries
07-Jul-14,-22.02,,,MISCELLANEOUS DEBIT,V1234 06/07 HFM ST IVES              ST IVES    74940524187,623.75,groceries
07-Jul-14,-33,,,MISCELLANEOUS DEBIT,V1234 05/07 THE COFFEE CLUB DARWIN   DARWIN     74940524186,645.77,eat
07-Jul-14,-2200,,,TRANSFER DEBIT,INTERNET TRANSFER   save                m,678.77,transfer
07-Jul-14,800,,,TRANSFER CREDIT,INTERNET TRANSFER   Rent                R and J,2878.77,parents
02-Jul-14,1241.87,,,SALARY,4666424             ANU,2078.77,salary
30-Jun-14,331.22,,,INTER-BANK CREDIT,7E1K0934208553998K  CTRLINK YTH ALL,836.9,centrelink
30-Jun-14,0.05,,,INTEREST PAID,,505.68,interest
27-Jun-14,-740,,,TRANSFER DEBIT,INTERNET TRANSFER   Rent,505.63,rent
26-Jun-14,-3.5,,,MISCELLANEOUS DEBIT,V1234 25/06 COCA COLA AMATIL         NORTH SYDN 74564724176,1245.63,eat
26-Jun-14,-11,,,MISCELLANEOUS DEBIT,V1234 24/06 NEWSLINK SD4             MASCOT     74940524176,1249.13,transport
25-Jun-14,-0.13,,,FEES,V1234 24/06 FOREIGN CURRENCY TRAN FEE           24692164175,1260.13,fun
24-Jun-14,-81,,,AUTOMATIC DRAWING,2000410934887       Telstra DDebit,1260.26,mobile
24-Jun-14,-6.6,,,MISCELLANEOUS DEBIT,V1234 24/06 Amazon Services-Kindle   866-216-10 24692164175,1341.26,fun
24-Jun-14,-10.45,,,MISCELLANEOUS DEBIT,V1234 21/06 MCDONALDS GOULBURN ST    GOULBURN D 74564724174,1347.86,eat
23-Jun-14,-28.5,,,MISCELLANEOUS DEBIT,V1234 23/06 COLES  MANLY PENINSULA   NSW        12345674174,1358.31,groceries
23-Jun-14,-12,,,MISCELLANEOUS DEBIT,V1234 20/06 DUSK AUSTRALASIA PTY     WAGGA WAGG 74940524171,1386.81,gifts
23-Jun-14,-84.11,,,MISCELLANEOUS DEBIT,V1234 21/06 COLES EXPR  WAGGA WAGGA  NSW        12345674172,1398.81,fuel
23-Jun-14,-38.99,,,MISCELLANEOUS DEBIT,V1234 21/06 BCF AUSTRALIA            WAGGA WAGG 74564454174,1482.92,gifts
23-Jun-14,300,,,TRANSFER CREDIT,INTERNET TRANSFER   mum                 mum,1521.91,groceries
23-Jun-14,-7.05,,,EFTPOS DEBIT,EFTPOS 23/06 10:31  Corse Pharmacy,1221.91,health
20-Jun-14,-49.95,,,EFTPOS DEBIT,EFTPOS 20/06 14:52  PORTMANS B87,1228.96,clothes
19-Jun-14,-45.11,,,MISCELLANEOUS DEBIT,V1234 19/06 COLES  GLENFIELD PARK    NSW        12345674170,1278.91,parents
19-Jun-14,-119,,,MISCELLANEOUS DEBIT,V1234 18/06 MYER  WAGGA              WAGGA WAGG 74564454169,1324.02,parents
19-Jun-14,-90.97,,,MISCELLANEOUS DEBIT,V1234 18/06 MYER  WAGGA              WAGGA WAGG 74564454169,1443.02,parents
18-Jun-14,1241.87,,,SALARY,4666424             ANU,1533.99,salary
18-Jun-14,-75.22,,,MISCELLANEOUS DEBIT,V1234 18/06 WOOLWORTHS 1273          WAGGA WAGG 03164574398,292.12,parents
17-Jun-14,-40.83,,,MISCELLANEOUS DEBIT,V1234 17/06 COLES  GLENFIELD PARK    NSW        12345674167,367.34,parents
17-Jun-14,-17,,,EFTPOS DEBIT,EFTPOS 17/06 09:31  STH CITY QUAL MEATS,408.17,parents
16-Jun-14,331.22,,,INTER-BANK CREDIT,7E1K0554208553998K  CTRLINK YTH ALL,425.17,centrelink
16-Jun-14,-37.98,,,MISCELLANEOUS DEBIT,V1234 16/06 SPOTLIGHT WAGGA WA       EAST WAGGA 01121749738,93.95,clothes
16-Jun-14,-39.36,,,MISCELLANEOUS DEBIT,V1234 14/06 COLES  GLENFIELD PARK    NSW        12345674165,131.93,parents
16-Jun-14,-5.29,,,MISCELLANEOUS DEBIT,V1234 12/06 SUPABARN CITY            CANBERRA   74564454164,171.29,groceries
16-Jun-14,-1500,,,TRANSFER DEBIT,INTERNET TRANSFER   save                mj,176.58,transfer
16-Jun-14,200,,,TRANSFER CREDIT,INTERNET TRANSFER   Mum                 Groceries,1676.58,parents
16-Jun-14,-20,,,EFTPOS DEBIT,EFTPOS 15/06 20:35  WOOLWORTHS      1273CASH OUT    $20.00,1476.58,groceries
16-Jun-14,-35,,,EFTPOS DEBIT,EFTPOS 14/06 15:23  STH CITY QUAL MEATS,1496.58,groceries
13-Jun-14,-7.51,,,MISCELLANEOUS DEBIT,V1234 12/06 ALDI                     CANBERRA   04142298766,1531.58,groceries
13-Jun-14,-740,,,TRANSFER DEBIT,INTERNET TRANSFER   Rent,1539.09,rent
12-Jun-14,-4.99,,,MISCELLANEOUS DEBIT,V1234 11/06 WOOLWORTHS1073           DICKSON    03194228233,2279.09,groceries
11-Jun-14,-38,,,MISCELLANEOUS DEBIT,V1234 11/06 TARGET  CANBERRA CIVIC   ACT        12345674162,2284.08,clothes
11-Jun-14,-15,,,EFTPOS DEBIT,EFTPOS 10/06 19:37  TONGUE GROOVE PUB,2322.08,eat
10-Jun-14,-85,,,MISCELLANEOUS DEBIT,V1234 10/06 TARGET  CANBERRA CIVIC   ACT        12345674161,2337.08,clothes
09-Jun-14,-16.54,,,MISCELLANEOUS DEBIT,V1234 09/06 WOOLWORTHS1073           DICKSON    01090318956,2422.08,groceries
09-Jun-14,-2.4,,,MISCELLANEOUS DEBIT,V1234 09/06 WOOLWORTHS1073           DICKSON    01191271862,2438.62,groceries
09-Jun-14,-30.09,,,MISCELLANEOUS DEBIT,V1234 06/06 ALDI                     CANBERRA   05183963193,2441.02,groceries
09-Jun-14,-20,,,ATM DEBIT,BBL ATM    08th11:39148 BUNDA STREET,2471.11,eat
06-Jun-14,-18.5,,,MISCELLANEOUS DEBIT,V1234 04/06 GRILLD PTY LTD           CANBERRA   74940524156,2491.11,eat
06-Jun-14,800,,,TRANSFER CREDIT,INTERNET TRANSFER   Rent                R and J,2509.61,parents
05-Jun-14,-15.02,,,MISCELLANEOUS DEBIT,V1234 04/06 ALDI                     CANBERRA   03184501775,1709.61,groceries
04-Jun-14,1241.87,,,SALARY,4666424             ANU,1724.63,salary
04-Jun-14,-13,,,MISCELLANEOUS DEBIT,V1234 02/06 AUSSIE FARMERS DIRECT    RICHMOND   74940524154,482.76,groceries
02-Jun-14,331.22,,,INTER-BANK CREDIT,7E1K0174208553998K  CTRLINK YTH ALL,495.76,centrelink
02-Jun-14,-20.06,,,MISCELLANEOUS DEBIT,V1234 31/05 WOOLWORTHS1073           DICKSON    06085046542,164.54,groceries
02-Jun-14,-740,,,TRANSFER DEBIT,INTERNET TRANSFER   Rent,184.6,rent
30-May-14,750,,,INTER-BANK CREDIT,Thread Harvest Pay  JAI SHARMA,924.6,business
30-May-14,-13.49,,,MISCELLANEOUS DEBIT,V1234 30/05 WOOLWORTHS1073           DICKSON    05174149220,174.6,groceries
30-May-14,-9.31,,,MISCELLANEOUS DEBIT,V1234 29/05 ALDI                     CANBERRA   04154045417,188.09,groceries
30-May-14,-10.68,,,MISCELLANEOUS DEBIT,V1234 29/05 WOOLWORTHS1073           DICKSON    04192251741,197.4,groceries
30-May-14,-100,,,TRANSFER DEBIT,INTERNET TRANSFER   mike jac,208.08,gifts
30-May-14,-63.29,,,EFTPOS DEBIT,EFTPOS 30/05 10:16  IGA CITY WEST CAR PACASH OUT    $50.00,308.08,groceries
29-May-14,300,,,TRANSFER CREDIT,INTERNET TRANSFER   unsave              Mikey,371.37,transfer
28-May-14,-90.88,,,MISCELLANEOUS DEBIT,V1234 28/05 WW PETROL 1566           DICKSON    03150768300,71.37,fuel
28-May-14,-11.9,,,MISCELLANEOUS DEBIT,V1234 26/05 CURRY MILD & DINE MA     MANLY VALE 74564504147,162.25,eat
28-May-14,-380,,,EFTPOS DEBIT,EFTPOS 28/05 15:38  ELFAR AND ELHOUFY P/,174.15,health
27-May-14,-37,,,MISCELLANEOUS DEBIT,V1234 26/05 MURRAYS AUSTRALIA LIMITEDRED HILL   74564454146,554.15,transport
27-May-14,-9.4,,,MISCELLANEOUS DEBIT,V1234 26/05 FOVEAUX SUPERMARKET      NORTH SYDN 74940524146,591.15,groceries
27-May-14,-3.99,,,EFTPOS DEBIT,EFTPOS 27/05 15:47  LYNEHAM SUPERMARKET,600.55,groceries
26-May-14,15,,,INTER-BANK CREDIT,Emma Present        MICHAEL WINDEYER,604.54,gifts
26-May-14,15,,,INTER-BANK CREDIT,Emma R Gift Louisa  JIA TANG,589.54,gifts
26-May-14,-3,,,MISCELLANEOUS DEBIT,V1234 24/05 WOOLWORTHS1073           DICKSON    06185979126,574.54,groceries
26-May-14,-3,,,MISCELLANEOUS DEBIT,V1234 23/05 CAPITAL PARKING PTY      CANBERRA   74940524144,577.54,groceries
26-May-14,-72.96,,,MISCELLANEOUS DEBIT,V1234 23/05 ALDI                     CANBERRA   05192711922,580.54,groceries
26-May-14,-1.9,,,EFTPOS DEBIT,EFTPOS 25/05 15:33  HANDYWAY RAIL CORP,653.5,transport
26-May-14,-54.85,,,EFTPOS DEBIT,EFTPOS 23/05 18:34  PP CANBERRA PTY LTD,655.4,gifts
23-May-14,-19.13,,,MISCELLANEOUS DEBIT,V1234 22/05 WOOLWORTHS1073           DICKSON    04220871427,710.25,groceries
22-May-14,-82,,,AUTOMATIC DRAWING,2000410934887       Telstra DDebit,729.38,mobile
22-May-14,-9.99,,,MISCELLANEOUS DEBIT,V1234 21/05 WOOLWORTHS1073           DICKSON    03193856717,811.38,groceries
22-May-14,-740,,,ATM DEBIT,BQL ATM DE 22nd13:06Braddon      AU,821.37,rent
21-May-14,1241.87,,,SALARY,4666424             ANU,1561.37,salary
20-May-14,-7.42,,,MISCELLANEOUS DEBIT,V1234 15/05 O'CONNOR IGA             O'CONNOR   74564504136,319.5,groceries
20-May-14,-140.5,,,TRANSFER DEBIT,INTERNET BPAY       ANU                 430434666424,326.92,education
20-May-14,-35,,,EFTPOS DEBIT,EFTPOS 20/05 13:40  UNICYCLES,467.42,household
19-May-14,331.22,,,INTER-BANK CREDIT,7E1K9793208553998K  CTRLINK YTH ALL,502.42,centrelink
19-May-14,-13.35,,,MISCELLANEOUS DEBIT,V1234 18/05 WOOLWORTHS1073           DICKSON    07115894255,171.2,groceries
19-May-14,-35.09,,,MISCELLANEOUS DEBIT,V1234 17/05 WOOLWORTHS1073           DICKSON    06110095014,184.55,groceries
15-May-14,-8.43,,,MISCELLANEOUS DEBIT,V1234 14/05 ALDI                     MACQUARIE  03172879114,219.64,groceries
15-May-14,-12.59,,,MISCELLANEOUS DEBIT,V1234 14/05 WOOLWORTHS1073           DICKSON    03194087491,228.07,groceries
15-May-14,-230,,,EFTPOS DEBIT,EFTPOS 14/05 17:01  ELFAR AND ELHOUFY P/,240.66,health
14-May-14,-91,,,MISCELLANEOUS DEBIT,V1234 14/05 ANU Parking Off 2        Aust Nat U 74619704133,470.66,car
14-May-14,-232,,,MISCELLANEOUS DEBIT,V1234 13/05 ACTEWAGL RETAIL          CANBERRA   74564724133,561.66,electricity
14-May-14,300,,,TRANSFER CREDIT,INTERNET TRANSFER   unsave              Mikey,793.66,transfer
13-May-14,-39.97,,,MISCELLANEOUS DEBIT,V1234 12/05 BUNNINGS 436000          BELCONNEN  74940524132,493.66,household
12-May-14,-10.44,,,MISCELLANEOUS DEBIT,V1234 11/05 WOOLWORTHS1073           DICKSON    07115260099,533.63,groceries
12-May-14,-51.11,,,MISCELLANEOUS DEBIT,V1234 11/05 BUNNINGS 436000          BELCONNEN  74940524131,544.07,household
12-May-14,-40.08,,,MISCELLANEOUS DEBIT,V1234 10/05 WOOLWORTHS1073           DICKSON    06122617615,595.18,groceries
12-May-14,-5.34,,,MISCELLANEOUS DEBIT,V1234 10/05 WOOLWORTHS1073           DICKSON    06210545121,635.26,groceries
12-May-14,-5.9,,,MISCELLANEOUS DEBIT,V1234 09/05 WOOLWORTHS1073           DICKSON    05202265821,640.6,groceries
12-May-14,-3,,,FEES,CUECARD    10th10:53A2GF - ACT S/A 1     DIR CHG OTH ATM,646.5,cash
12-May-14,-100,,,ATM DEBIT,CUECARD    10th10:53A2GF - ACT S/A 1,649.5,cash
12-May-14,-33.33,,,TRANSFER DEBIT,INTERNET TRANSFER   mums day,749.5,gifts
09-May-14,-16.45,,,MISCELLANEOUS DEBIT,V1234 08/05 BEACH BURRITO CANBER     CANBERRA   74940524128,782.83,eat
09-May-14,-15.04,,,MISCELLANEOUS DEBIT,V1234 08/05 ALDI                     CANBERRA   04174534323,799.28,groceries
09-May-14,-50,,,TRANSFER DEBIT,INTERNET TRANSFER   JacqWilliams,814.32,fun
08-May-14,-1500,,,TRANSFER DEBIT,INTERNET TRANSFER   save                mikey,864.32,transfer
07-May-14,1241.87,,,SALARY,4666424             ANU,2364.32,salary
06-May-14,800,,,TRANSFER CREDIT,INTERNET TRANSFER   Rent                R and J,1122.45,parents
05-May-14,331.22,,,INTER-BANK CREDIT,7E1K9413208553998K  CTRLINK YTH ALL,322.45,centrelink
05-May-14,-45.68,,,MISCELLANEOUS DEBIT,V1234 04/05 ALDI                     CANBERRA   07115801745,-8.77,groceries
05-May-14,-91.19,,,MISCELLANEOUS DEBIT,V1234 03/05 WW PETROL 1566           DICKSON    06134159079,36.91,fuel
05-May-14,-38,,,MISCELLANEOUS DEBIT,V1234 03/05 WOOLWORTHS1073           DICKSON    06141286432,128.1,groceries
05-May-14,-20.73,,,MISCELLANEOUS DEBIT,V1234 03/05 WOOLWORTHS1073           DICKSON    06141274431,166.1,groceries
05-May-14,-4.6,,,MISCELLANEOUS DEBIT,V1234 01/05 RAILCORP TS WYNYARD      SYDNEY     74564724122,186.83,transport
05-May-14,-0.8,,,MISCELLANEOUS DEBIT,V1234 01/05 MCDONALDS DICKSON        DICKSON    74564724122,191.43,eat
05-May-14,300,,,TRANSFER CREDIT,INTERNET TRANSFER   unsave              Mikey,192.23,transfer
05-May-14,-427,,,EFTPOS DEBIT,EFTPOS 05/05 16:49  KMART AUTO  BRADDON,-107.77,car
02-May-14,-740,,,TRANSFER DEBIT,INTERNET TRANSFER   Rent,319.23,rent
02-May-14,500,,,TRANSFER CREDIT,INTERNET TRANSFER   unsave              Mikey,1059.23,transfer
01-May-14,-2.5,,,FEES,CUECARD    01st13:19WAKEHURST GOLF CLUB  DIR CHG OTH ATM,559.23,cash
01-May-14,-100,,,ATM DEBIT,CUECARD    01st13:19WAKEHURST GOLF CLUB,561.73,cash
01-May-14,-1.9,,,EFTPOS DEBIT,EFTPOS 01/05 09:59  CENTRAL ELEC C/RAIL,661.73,transport
01-May-14,-1.9,,,EFTPOS DEBIT,EFTPOS 01/05 17:45  HANDYWAY RAIL CORPO,663.63,transport
30-Apr-14,-350,,,EFTPOS DEBIT,EFTPOS 29/04 08:27  ELFAR AND ELHOUFY P/,665.53,health
29-Apr-14,-21.19,,,MISCELLANEOUS DEBIT,V1234 29/04 WOOLWORTHS1073           DICKSON    02095004815,1015.53,groceries
29-Apr-14,-3,,,MISCELLANEOUS DEBIT,V1234 29/04 WOOLWORTHS1073           DICKSON    02173352482,1036.72,groceries
29-Apr-14,-20,,,ATM DEBIT,NABATM CSH 29th12:19AUSTRALIAN NATIONAL,1039.72,fun
28-Apr-14,-48,,,MISCELLANEOUS DEBIT,V1234 26/04 MURRAYS AUSTRALIA LIMITEDRED HILL   74564454118,1059.72,transport
24-Apr-14,-12000,,,TRANSFER DEBIT,INTERNET TRANSFER fhs,1107.72,transfer
24-Apr-14,-1300,,,TRANSFER DEBIT,INTERNET TRANSFER save Mikey,13107.72,transfer
24-Apr-14,650,,,DEPOSIT,CASH,14407.72,transfer
23-Apr-14,-66,,,AUTOMATIC DRAWING,2000410934887 Telstra DDebit asher. m and j,13757.72,mobile
23-Apr-14,1241.87,,,SALARY,4666424 ANU Michael Asher,13823.72,salary
22-Apr-14,-740,,,TRANSFER DEBIT,INTERNET TRANSFER Rent,12581.85,rent
22-Apr-14,1.79,,,MISCELLANEOUS CREDIT,V1234 16/04 PAYPAL * DEALEXTREME 402 9357733 74423424107,13321.85,household
17-Apr-14,-38.9,,,MISCELLANEOUS DEBIT,V1234 15/04 ALDI CAN BERRA 02175271355,13320.06,groceries
17-Apr-14,331.22,,,INTER-BANK CREDIT,7E1K9071208553998K CTRLINK YTH ALL JACQUELINE ANNE,13358.96,centrelink
16-Apr-14,12000,,,DEPOSIT,CHEQUES,13027.74,transfer
15-Apr-14,-28.25,,,MISCELLANEOUS DEBIT,V1234 14/04 WOOLWORT HS1073 DIC KSON 01210792588,1027.74,groceries
14-Apr-14,-6000,,,TRANSFER DEBIT,INTERNET TRANSFER firsthome,1055.99,transfer
14-Apr-14,-32.9,,,MISCELLANEOUS DEBIT,V1234 12/04 WOOLWORT HS 1209 WAG GA WAGG 06143096179,7055.99,groceries
14-Apr-14,-31.18,,,MISCELLANEOUS DEBIT,V1234 12/04 WESTSIDE PETROLEUMWAG WAG GA WAGG 06175190003,7088.89,fuel
14-Apr-14,-26.49,,,MISCELLANEOUS DEBIT,V1234 12/04 WOW 1441 WAGGA WAG GA WAGG 06174971914,7120.07,groceries
14-Apr-14,-14.14,,,MISCELLANEOUS DEBIT,V1234 12/04 WOOLWORT HS 1209 WAG GA WAGG 06175163612,7146.56,groceries
14-Apr-14,-6,,,MISCELLANEOUS DEBIT,V1234 13/04 WOOLWORT HS 1273 WAG GA WAGG 07206161018,7160.7,groceries
14-Apr-14,-5.08,,,MISCELLANEOUS DEBIT,V1234 13/04 WOOLWORT HS 1273 WAG GA WAGG 07206015763,7166.7,groceries
14-Apr-14,700,,,TRANSFER CREDIT,INTERNET TRANSFER unsave Mikey,7171.78,transfer
14-Apr-14,5000,,,TRANSFER CREDIT,INTERNET TRANSFER unsave Mikey,6471.78,transfer
10-Apr-14,-77.92,,,MISCELLANEOUS DEBIT,V1234 10/04 WW PETRO L 1566 DIC KSON 04180206651,1471.78,fuel
10-Apr-14,-18.1,,,MISCELLANEOUS DEBIT,V1234 10/04 WOOLWORT HS1073 DIC KSON 04180113209,1549.7,groceries
10-Apr-14,-8,,,MISCELLANEOUS DEBIT,V1234 09/04 BANNY EN TERPRISES PT NAR OOMA 74940524099,1567.8,holiday
09-Apr-14,-60,,,EFTPOS DEBIT,EFTPOS 09/04 12:29 C A HOLMES PTY LTD NAROOMA NSW,1575.8,holiday
09-Apr-14,-32,,,EFTPOS DEBIT,EFTPOS 09/04 19:32 WILDFIRE HOSPITALITY NAROOMA NS,1635.8,holiday
09-Apr-14,-8.68,,,MISCELLANEOUS DEBIT,V1234 09/04 WOOLWORT HS 1267 NAR OOMA 03110940530,1667.8,holiday
09-Apr-14,1241.87,,,SALARY,4666424 ANU Michael Asher,1676.48,salary
08-Apr-14,-6000,,,TRANSFER DEBIT,INTERNET TRANSFER firsthome,434.61,transfer
08-Apr-14,-5.51,,,MISCELLANEOUS DEBIT,V1234 08/04 WOOLWORT HS 1267 NAR OOMA 02143339399,6434.61,holiday
08-Apr-14,2300,,,TRANSFER CREDIT,INTERNET TRANSFER unsave unsave,6440.12,transfer
07-Apr-14,-49.95,,,EFTPOS DEBIT,EFTPOS 07/04 10:36 RJ NOMCHONG 0001 BRAIDWOOD,4140.12,car
07-Apr-14,-40,,,EFTPOS DEBIT,EFTPOS 07/04 11:34 CALTEX PAY@PUMP BATEMANS BAY,4190.07,car
07-Apr-14,-26.16,,,MISCELLANEOUS DEBIT,V1234 05/04 WOOLWORT HS1073 DIC KSON 06185769327,4230.07,groceries
07-Apr-14,-25.76,,,MISCELLANEOUS DEBIT,V1234 04/04 WOOLWORT HS1073 DIC KSON 05192334466,4256.23,groceries
07-Apr-14,-25,,,MISCELLANEOUS DEBIT,V1234 06/04 ENTER CA FE CAN BERRA 74564454097,4281.99,eat
07-Apr-14,-9.79,,,MISCELLANEOUS DEBIT,V1234 07/04 WOOLWORT HS 1267 NAR OOMA 01154569013,4306.99,holiday
07-Apr-14,1700,,,TRANSFER CREDIT,INTERNET TRANSFER Rent R and J,4316.78,parents
07-Apr-14,2402.82,,,INTER-BANK CREDIT,7E1K8767208553998K CTRLINK YTH ALL JACQUELINE ANNE,2616.78,centrelink
04-Apr-14,-740,,,TRANSFER DEBIT,INTERNET TRANSFER Rent,213.96,rent
04-Apr-14,-19.61,,,MISCELLANEOUS DEBIT,V1234 03/04 WOOLWORT HS1073 DIC KSON 05000749968,953.96,groceries
03-Apr-14,-1,,,MISCELLANEOUS DEBIT,V1234 01/04 CAPITAL PARKING PTY CAN BERRA 74940524092,973.57,groceries
02-Apr-14,-66.42,,,MISCELLANEOUS DEBIT,V1234 01/04 ALDI CAN BERRA 02203929647,974.57,groceries
01-Apr-14,-1.7,,,MISCELLANEOUS DEBIT,V1234 31/03 WOOLWORT HS1073 DIC KSON 01185055410,1040.99,groceries
31-Mar-14,-88.59,,,MISCELLANEOUS DEBIT,V1234 30/03 WW PETRO L 1566 DIC KSON 07150374623,1042.69,fuel
31-Mar-14,-20.14,,,MISCELLANEOUS DEBIT,V1234 30/03 WOOLWORT HS1073 DIC KSON 07090057434,1131.28,groceries
31-Mar-14,0.04,,,INTEREST PAID,INTEREST,1151.42,interest
28-Mar-14,-20.07,,,MISCELLANEOUS DEBIT,V1234 28/03 WOOLWORT HS1073 DIC KSON 05170455211,1151.38,groceries
27-Mar-14,-50,,,ATM DEBIT,NABATM CSH 27th10:39 AUSTRALIAN NATIONAL,1171.45,cash
27-Mar-14,-20,,,EFTPOS DEBIT,EFTPOS 27/03 10:01 UNIVERSITY OF CANBER CANBERRA ACT,1221.45,health
27-Mar-14,-11.99,,,MISCELLANEOUS DEBIT,V1234 27/03 WOOLWORT HS1073 DIC KSON 04102881164,1241.45,groceries
27-Mar-14,-11,,,EFTPOS DEBIT,EFTPOS 27/03 10:14 DEEK'S 0001 DICKSON,1253.44,gifts
26-Mar-14,1241.87,,,SALARY,4666424 ANU Michael Asher,1264.44,salary
25-Mar-14,-66,,,AUTOMATIC DRAWING,2000410934887 Telstra DDebit asher. m and j,22.57,mobile
25-Mar-14,-64.95,,,MISCELLANEOUS DEBIT,V1234 24/03 ALDI MAC QUARIE 01180186162,88.57,groceries
25-Mar-14,-47.7,,,MISCELLANEOUS DEBIT,V1234 23/03 CANBERRA HOGS PTY LTD CIV IC SQUA 74564724083,153.52,eat
25-Mar-14,-4.1,,,MISCELLANEOUS DEBIT,V1234 25/03 THE CLUB GROUP CAN BERRA C 02081546997,201.22,eat
24-Mar-14,-200,,,ATM DEBIT,NABATM CSH 23rd13:15 AUSTRALIAN NATIONAL,205.32,cash
24-Mar-14,-7,,,MISCELLANEOUS DEBIT,V1234 22/03 HOTEL OP PTY LTD CAN BERRA 74940524082,405.32,eat
24-Mar-14,-4,,,MISCELLANEOUS DEBIT,V1234 22/03 MOCAN GR EEN GROUT CAN BERRA 06143826280,412.32,eat
24-Mar-14,-4,,,MISCELLANEOUS DEBIT,V1234 23/03 LONSDALE COFFEE GROU BRA DDON 74940524082,416.32,eat
24-Mar-14,-3.98,,,MISCELLANEOUS DEBIT,V1234 21/03 SUPABARN CITY CAN BERRA 74564454083,420.32,groceries
21-Mar-14,-740,,,TRANSFER DEBIT,INTERNET TRANSFER Rent,424.3,rent
21-Mar-14,-15.99,,,MISCELLANEOUS DEBIT,V1234 20/03 WOOLWORT HS1073 DIC KSON 04183999787,1164.3,groceries
21-Mar-14,-14,,,MISCELLANEOUS DEBIT,V1234 21/03 THE CUPP ING ROOM CAN BERRA 05152717209,1180.29,eat
21-Mar-14,-4.95,,,MISCELLANEOUS DEBIT,V1234 20/03 CAPITAL CHEMIST DCKSN DIC KSON 74564724079,1194.29,health
20-Mar-14,-20,,,EFTPOS DEBIT,EFTPOS 20/03 10:59 UNIVERSITY OF CANBER CANBERRA ACT,1199.24,health
19-Mar-14,-33.34,,,MISCELLANEOUS DEBIT,V1234 18/03 WOOLWORT HS1073 DIC KSON 02194053656,1219.24,groceries
18-Mar-14,-705,,,MISCELLANEOUS DEBIT,V1234 17/03 ELFAR AN D ELHOUFY P/L BEL CONNEN 01170756285,1252.58,health
18-Mar-14,780,,,TRANSFER CREDIT,INTERNET TRANSFER Dentist Mum,1957.58,health
17-Mar-14,-2.55,,,MISCELLANEOUS DEBIT,V1234 16/03 COLES EX PR GUNDAGAI NSW 12345674075,1177.58,eat
17-Mar-14,1000,,,TRANSFER CREDIT,INTERNET TRANSFER unsave Mikey,1180.13,transfer
14-Mar-14,-150,,,TRANSFER DEBIT,INTERNET TRANSFER Akubra,180.13,gifts
14-Mar-14,-67.27,,,MISCELLANEOUS DEBIT,V1234 13/03 WW PETRO L 1566 DIC KSON 05000725022,330.13,fuel
14-Mar-14,-30,,,EFTPOS DEBIT,EFTPOS 14/03 11:34 PASSION HAIR & BEAUT WAGGA WAGGA NS,397.4,beauty
14-Mar-14,-16.2,,,MISCELLANEOUS DEBIT,V1234 14/03 COLES G LENFIELD PARK NSW 12345674073,427.4,groceries
13-Mar-14,-1875,,,MISCELLANEOUS DEBIT,V1234 12/03 FORTY WI NKS FYS HWICK 74564454072,443.6,household
13-Mar-14,-300,,,TRANSFER DEBIT,INTERNET TRANSFER RENT,2318.6,rent
12-Mar-14,-575,,,EFTPOS DEBIT,EFTPOS 12/03 12:45 UNICYCLES ACTON ACT,2618.6,household
12-Mar-14,-25.27,,,MISCELLANEOUS DEBIT,V1234 12/03 WOOLWORT HS1073 DIC KSON 03164738547,3193.6,groceries
12-Mar-14,-20,,,ATM DEBIT,NABATM CSH 12th10:01 AUSTRALIAN NATIONAL,3218.87,cash
12-Mar-14,-18.69,,,MISCELLANEOUS DEBIT,V1234 11/03 WOOLWORT HS1073 DIC KSON 02195699906,3238.87,groceries
12-Mar-14,-4.99,,,MISCELLANEOUS DEBIT,V1234 12/03 WOOLWORT HS1073 DIC KSON 03164594124,3257.56,groceries
12-Mar-14,-4.89,,,MISCELLANEOUS DEBIT,V1234 12/03 WOOLWORT HS1073 DIC KSON 03175898601,3262.55,groceries
12-Mar-14,1000,,,TRANSFER CREDIT,INTERNET TRANSFER unsave Mikey,3267.44,transfer
12-Mar-14,1000,,,TRANSFER CREDIT,INTERNET TRANSFER unsave Mikey,2267.44,transfer
12-Mar-14,1241.87,,,SALARY,4666424 ANU Michael Asher,1267.44,salary
11-Mar-14,-56.88,,,MISCELLANEOUS DEBIT,V1234 10/03 ALDI MAC QUARIE 01185716010,25.57,groceries
11-Mar-14,-2.8,,,MISCELLANEOUS DEBIT,V1234 07/03 MCDONALD S YASS YAS S 74564724069,82.45,eat
10-Mar-14,-74.95,,,EFTPOS DEBIT,EFTPOS 08/03 14:43 UNEKE ANTIQUES 138 FITZMAURICE STRE,85.25,gifts
10-Mar-14,-70.84,,,MISCELLANEOUS DEBIT,V1234 08/03 Bush's M eats Wag ga Wagg 74249234067,160.2,groceries
10-Mar-14,-12.9,,,MISCELLANEOUS DEBIT,V1234 08/03 COLES W AGGA WAGGA NSW 12345674067,231.04,groceries
10-Mar-14,-9.99,,,MISCELLANEOUS DEBIT,V1234 07/03 SCP WAGG A PTY LTD GLE NFIELD 74940524066,243.94,health
10-Mar-14,-5.14,,,MISCELLANEOUS DEBIT,V1234 10/03 COLES J AMISON CENTRE ACT 12345674069,253.93,groceries
10-Mar-14,-4.3,,,MISCELLANEOUS DEBIT,V1234 08/03 MUFFIN B REAK WAGGA WAG GA WAGG 06151726609,259.07,eat
07-Mar-14,-640,,,TRANSFER DEBIT,INTERNET TRANSFER Rent,263.37,rent
07-Mar-14,-165,,,TRANSFER DEBIT,INTERNET TRANSFER JacqWilliams,903.37,fun
07-Mar-14,-123.33,,,MISCELLANEOUS DEBIT,V1234 07/03 WW PETRO L 1566 DIC KSON 05160588338,1068.37,fuel
07-Mar-14,-40.26,,,MISCELLANEOUS DEBIT,V1234 06/03 WOOLWORT HS1073 DIC KSON 05000602109,1191.7,groceries
07-Mar-14,-1.79,,,MISCELLANEOUS DEBIT,V1234 05/03 PAYPAL * DEALEXTREME 402 9357733 74423424065,1231.96,household
07-Mar-14,330,,,TRANSFER CREDIT,INTERNET TRANSFER unsave Mikey,1233.75,transfer
06-Mar-14,-1000,,,TRANSFER DEBIT,INTERNET TRANSFER save Mikey,903.75,transfer
06-Mar-14,-73.47,,,MISCELLANEOUS DEBIT,V1234 05/03 CO/OP BO OKSHOP 150 CAN BERRA 03145922312,1903.75,education
06-Mar-14,40,,,INTER-BANK CREDIT,iCAM couch RACHEL BLAKERS Michael Asher,1977.22,fun
06-Mar-14,1700,,,TRANSFER CREDIT,INTERNET TRANSFER Rent R and J,1937.22,parents
04-Mar-14,-127.9,,,MISCELLANEOUS DEBIT,V1234 01/03 ACTEWAGL RETAIL CAN BERRA 74564724062,237.22,household
04-Mar-14,-59.99,,,MISCELLANEOUS DEBIT,V1234 04/03 WOOLWORT HS1073 DIC KSON 02172166324,365.12,groceries
04-Mar-14,-55.5,,,EFTPOS DEBIT,EFTPOS 04/03 08:43 UNICYCLES ACTON ACT,425.11,household
04-Mar-14,-35.48,,,MISCELLANEOUS DEBIT,V1234 03/03 ALDI CAN BERRA 01172190413,480.61,groceries
04-Mar-14,-17.91,,,MISCELLANEOUS DEBIT,V1234 03/03 WOOLWORT HS1073 DIC KSON 01210695232,516.09,groceries
04-Mar-14,-11.5,,,MISCELLANEOUS DEBIT,V1234 02/03 GUZMAN Y GOMEZ CANBE CAN BERRA 74940524062,534,eat
04-Mar-14,-5,,,MISCELLANEOUS DEBIT,V1234 04/03 WOOLWORT HS1073 DIC KSON 02172178984,545.5,groceries
03-Mar-14,-360,,,ATM DEBIT,BBL ATM 02nd15:07 32 HARDWICK CRESCENT,550.5,cash
03-Mar-14,-106.97,,,MISCELLANEOUS DEBIT,V1234 28/02 PAYPAL * CHAINREACTI 353 1436900 74198814061,910.5,household
03-Mar-14,-60.03,,,MISCELLANEOUS DEBIT,V1234 02/03 BUNNINGS 461000 FYS HWICK 74940524061,1017.47,household
03-Mar-14,-47.92,,,EFTPOS DEBIT,EFTPOS 02/03 13:03 SHERIDAN FYSHWICK 0001 FYSHWICK,1077.5,household
03-Mar-14,-34.95,,,EFTPOS DEBIT,EFTPOS 02/03 14:31 HERITAGE NURSERY WESTON PARK BANKS S,1125.42,household
03-Mar-14,-14.99,,,MISCELLANEOUS DEBIT,V1234 01/03 WOOLWORT HS1073 DIC KSON 06125275423,1160.37,groceries
03-Mar-14,-6,,,EFTPOS DEBIT,EFTPOS 02/03 14:17 YARRALUMLA GALLERY 1 WESTON PARK ROAD,1175.36,household
03-Mar-14,-2.73,,,MISCELLANEOUS DEBIT,V1234 28/02 WOOLWORT HS1073 DIC KSON 05192466011,1181.36,groceries
28-Feb-14,-17.65,,,MISCELLANEOUS DEBIT,V1234 27/02 WOOLWORT HS1073 DIC KSON 04192396141,1184.09,groceries
28-Feb-14,-9.48,,,MISCELLANEOUS DEBIT,V1234 28/02 WOOLWORT HS1073 DIC KSON 05145949040,1201.74,groceries
28-Feb-14,10,,,MISCELLANEOUS CREDIT,V1234 27/02 WOOLWORT HS1073 DIC KSON 04184054434,1211.22,groceries
27-Feb-14,-12000,,,TRANSFER DEBIT,INTERNET TRANSFER home,1201.22,transfer
27-Feb-14,-30.63,,,MISCELLANEOUS DEBIT,V1234 27/02 WOOLWORT HS ON LINE BEL LA VIST 04140183323,13201.22,groceries
27-Feb-14,12000,,,TRANSFER CREDIT,INTERNET TRANSFER home Mikey,13231.85,transfer
26-Feb-14,-176.66,,,MISCELLANEOUS DEBIT,V1234 24/02 ALDI STO RES CAN BERRA 74564724056,1231.85,groceries
26-Feb-14,-158.11,,,EFTPOS DEBIT,EFTPOS 25/02 13:53 CO/OP BOOKSHOP 150 CONCESSIONS AREA AUS,1408.51,education
26-Feb-14,-56.92,,,MISCELLANEOUS DEBIT,V1234 26/02 WOOLWORT HS1073 DIC KSON 03160934025,1566.62,groceries
26-Feb-14,1241.87,,,SALARY,4666424 ANU Michael Asher,1623.54,salary
25-Feb-14,-845,,,EFTPOS DEBIT,EFTPOS 25/02 15:46 GOODGUYS FYSHWICK 8/20 TOWNSVILLE ST,381.67,household
25-Feb-14,-52.7,,,MISCELLANEOUS DEBIT,V1234 24/02 SUPABARN CITY CAN BERRA 74564454056,1226.67,groceries
25-Feb-14,-30,,,MISCELLANEOUS DEBIT,V1234 24/02 AUSTRALI A POST 225672 AUS TRALIAN 74940524055,1279.37,gifts
25-Feb-14,-24.9,,,EFTPOS DEBIT,EFTPOS 24/02 09:56 39 STEPS O'CONNOR AC,1309.37,eat
25-Feb-14,1000,,,TRANSFER CREDIT,INTERNET TRANSFER unsave Mikey,1334.27,transfer
24-Feb-14,-625,,,TRANSFER DEBIT,INTERNET TRANSFER 0,334.27,household
24-Feb-14,-109.49,,,MISCELLANEOUS DEBIT,V1234 21/02 BP EXP M ARULAN 2330 MAR ULAN NO 05184263102,959.27,fuel
24-Feb-14,-73.52,,,MISCELLANEOUS DEBIT,V1234 21/02 BP EXP M ARULAN 2330 MAR ULAN NO 05180152922,1068.76,fuel
24-Feb-14,-71.5,,,AUTOMATIC DRAWING,2000410934887 Telstra DDebit asher. m and j,1142.28,mobile
24-Feb-14,-60.79,,,MISCELLANEOUS DEBIT,V1234 21/02 CALTEX GUM LY GUML 74940524053,1213.78,fuel
24-Feb-14,-26.01,,,MISCELLANEOUS DEBIT,V1234 22/02 BUNNINGS 594000 ART ARMON 74940524053,1274.57,gifts
24-Feb-14,-20.28,,,MISCELLANEOUS DEBIT,V1234 22/02 IGA RITE WAY WAHROONGA WAH ROONGA 74940524053,1300.58,groceries
24-Feb-14,70.02,,,MISCELLANEOUS CREDIT,V1234 21/02 BP EXP M ARULAN 2330 MAR ULAN NO 05184107233,1320.86,fuel
21-Feb-14,-785,,,EFTPOS DEBIT,EFTPOS 20/02 13:39 HARVEY NORMAN AV/IT WAGGA NS,1250.84,household
21-Feb-14,-148.98,,,MISCELLANEOUS DEBIT,V1234 20/02 BUNNINGS 737000 ASH MONT 74940524051,2035.84,household
21-Feb-14,-12,,,EFTPOS DEBIT,EFTPOS 20/02 16:57 THE REJECT SHOP 0242 WAGGA WAGGA NS,2184.82,household
21-Feb-14,-3.93,,,MISCELLANEOUS DEBIT,V1234 21/02 WW PETRO L 1566 DIC KSON 05151449978,2196.82,eat
21-Feb-14,1000,,,TRANSFER CREDIT,INTERNET TRANSFER unsave Mikey,2200.75,transfer
20-Feb-14,-77,,,EFTPOS DEBIT,EFTPOS 20/02 12:38 LIFESTYLE LIGHTING W WAGGA WAGGA NSW,1200.75,household
20-Feb-14,-19.73,,,EFTPOS DEBIT,EFTPOS 20/02 10:44 COLES WAGGA WAGGA NSW AU,1277.75,groceries
20-Feb-14,600,,,TRANSFER CREDIT,INTERNET TRANSFER unsave Mikey,1297.48,transfer
19-Feb-14,-6500,,,TRANSFER DEBIT,INTERNET TRANSFER unhome mikey,697.48,transfer
19-Feb-14,-2220,,,MISCELLANEOUS DEBIT,WITHDRAWAL,7197.48,rent
19-Feb-14,-102.59,,,EFTPOS DEBIT,EFTPOS 18/02 18:40 WW PETROL 1566 \DICKSON ACT AU,9417.48,fuel
19-Feb-14,-45.46,,,EFTPOS DEBIT,EFTPOS 18/02 11:31 SUPABARN CITY CANBERRA AC,9520.07,groceries
19-Feb-14,-21,,,EFTPOS DEBIT,EFTPOS 19/02 14:01 ENTER CAFE CANBERRA AC,9565.53,eat
19-Feb-14,-21,,,MISCELLANEOUS DEBIT,V1234 19/02 BIG W 12 2 CAN BERRA C 03161156139,9586.53,fun
19-Feb-14,-16.04,,,MISCELLANEOUS DEBIT,V1234 17/02 ALDI STO RES CAN BERRA 74564724049,9607.53,groceries
19-Feb-14,6000,,,TRANSFER CREDIT,INTERNET TRANSFER home mikey,9623.57,transfer
18-Feb-14,-100,,,TRANSFER DEBIT,INTERNET TRANSFER fridge asher asher,3623.57,household
18-Feb-14,-24.5,,,EFTPOS DEBIT,EFTPOS 17/02 12:32 DUXTON AT O CONNOR P 12 MCPHERSON STREET,3723.57,eat
18-Feb-14,-14.2,,,MISCELLANEOUS DEBIT,V1234 16/02 O'CONNOR IGA OCO NNOR 74564504048,3748.07,groceries
18-Feb-14,2220,,,TRANSFER CREDIT,INTERNET TRANSFER bond Mikey,3762.27,transfer
17-Feb-14,-13.5,,,MISCELLANEOUS DEBIT,V1234 16/02 OFFICEWO RKS BRADDON ACT 12345674046,1542.27,gifts
17-Feb-14,-7.37,,,MISCELLANEOUS DEBIT,V1234 17/02 OFFICEWO RKS BRADDON ACT 12345674048,1555.77,gifts
14-Feb-14,-85.09,,,MISCELLANEOUS DEBIT,V1234 14/02 COLES EX PR BRADDON ACT 12345674045,1563.14,fuel
14-Feb-14,-59.48,,,MISCELLANEOUS DEBIT,V1234 14/02 WOOLWORT HS1073 DIC KSON 05160435118,1648.23,groceries
14-Feb-14,-6.7,,,MISCELLANEOUS DEBIT,V1234 12/02 O'CONNOR IGA OCO NNOR 74564504044,1707.71,groceries
13-Feb-14,-27,,,EFTPOS DEBIT,EFTPOS 12/02 13:22 DUXTON AT O CONNOR P 12 MCPHERSON STREET,1714.41,eat
13-Feb-14,-10,,,MISCELLANEOUS DEBIT,V1234 13/02 OFFICEWO RKS BRADDON ACT 12345674044,1741.41,gifts
13-Feb-14,-1,,,MISCELLANEOUS DEBIT,V1234 13/02 OFFICEWO RKS BRADDON ACT 12345674043,1751.41,gifts
12-Feb-14,-40,,,EFTPOS DEBIT,EFTPOS 12/02 16:18 CALLIDORA PTY LTD RTH CANBERRA ACT,1752.41,fun
12-Feb-14,-30,,,MISCELLANEOUS DEBIT,V1234 11/02 PILLOW T ALK MAJ URA 74564454043,1792.41,household
12-Feb-14,-4.39,,,MISCELLANEOUS DEBIT,V1234 11/02 SUPABARN CITY CAN BERRA 74564454043,1822.41,groceries
12-Feb-14,1241.87,,,SALARY,4666424 ANU Michael Asher,1826.8,salary
11-Feb-14,-647.19,,,MISCELLANEOUS DEBIT,V1234 10/02 BUDGET R ENT A CAR HOB ART 74564454041,584.93,holiday
11-Feb-14,-49.99,,,EFTPOS DEBIT,EFTPOS 11/02 10:03 OZMOSIS CANBERRA CEN CANBERRA AC,1232.12,fun
11-Feb-14,-37.85,,,MISCELLANEOUS DEBIT,V1234 10/02 CNBR ARP T WOW 1419 CAN BERRA A 01195807562,1282.11,fun
11-Feb-14,-16.5,,,MISCELLANEOUS DEBIT,V1234 11/02 BIG W 12 2 CAN BERRA C 02096157570,1319.96,household
11-Feb-14,-15,,,EFTPOS DEBIT,EFTPOS 11/02 12:55 UNIVERSAL PHONE SERV CANBERRA AC,1336.46,mobile
11-Feb-14,-11.5,,,MISCELLANEOUS DEBIT,V1234 09/02 GUZMAN Y GOMEZ CANBE CAN BERRA 74940524041,1351.46,eat
11-Feb-14,-5.52,,,MISCELLANEOUS DEBIT,V1234 11/02 CNBR ARP T WOW 1419 CAN BERRA A 02172453714,1362.96,eat
10-Feb-14,-5000,,,TRANSFER DEBIT,INTERNET TRANSFER save mikey,1368.48,transfer
10-Feb-14,-78.76,,,EFTPOS DEBIT,EFTPOS 08/02 09:31 RAM NARAYAN RAM SERV MURRUMBATEMA NSW,6368.48,fuel
10-Feb-14,-20.48,,,MISCELLANEOUS DEBIT,V1234 09/02 CNBR ARP T WOW 1419 CAN BERRA A 07131849672,6447.24,fun
10-Feb-14,-20.02,,,EFTPOS DEBIT,EFTPOS 08/02 15:44 OCONNOR IGA 0001 OCONNOR,6467.72,groceries
10-Feb-14,-9,,,MISCELLANEOUS DEBIT,V1234 09/02 BIG W 12 9 GUN GAHLIN 07103228127,6487.74,household
10-Feb-14,-8.99,,,EFTPOS DEBIT,EFTPOS 08/02 18:04 LYNEHAM SUPERMARKET 0001 LYNEHAM,6496.74,groceries
07-Feb-14,-129.99,,,EFTPOS DEBIT,EFTPOS 07/02 15:56 SPORTSMANS WAREHSE 34 BAYLIS STREET,6505.73,clothes
07-Feb-14,-78,,,EFTPOS DEBIT,EFTPOS 07/02 12:01 WHITINGS DRYCLEANING WAGGA WAGGNSWAU,6635.72,clothes
07-Feb-14,-73.62,,,MISCELLANEOUS DEBIT,V1234 06/02 ETSY.COM - STRIDERIDGE ETS Y.COM 74779024038,6713.72,gifts
07-Feb-14,-72.76,,,MISCELLANEOUS DEBIT,V1234 07/02 COLES W AGGA WAGGA NSW 12345674038,6787.34,groceries
07-Feb-14,-4.99,,,MISCELLANEOUS DEBIT,V1234 07/02 WOOLWORT HS 1209 WAG GA WAGG 05163911652,6860.1,groceries
07-Feb-14,-4.3,,,MISCELLANEOUS DEBIT,V1234 07/02 MUFFIN B REAK WAGGA WAG GA WAGG 05115149379,6865.09,eat
07-Feb-14,-3.3,,,MISCELLANEOUS DEBIT,V1234 06/02 BUNNINGS 737000 ASH MONT 74940524037,6869.39,household
07-Feb-14,-2.95,,,MISCELLANEOUS DEBIT,V1234 05/02 HJ BUNKE R HILL KAL KALLO 74564724037,6872.69,eat
06-Feb-14,-24.99,,,MISCELLANEOUS DEBIT,V1234 06/02 THE BOOK SHOP WAGGA WAG GA WAGG 04145748466,6875.64,gifts
06-Feb-14,-17.8,,,MISCELLANEOUS DEBIT,V1234 05/02 SAFEWAY 3101 BEN ALLA 03184901126,6900.63,groceries
06-Feb-14,-11.95,,,EFTPOS DEBIT,EFTPOS 06/02 14:49 Kitchen Antics Wagga Wagga AU,6918.43,gifts
06-Feb-14,-9.49,,,MISCELLANEOUS DEBIT,V1234 06/02 WOOLWORT HS 1209 WAG GA WAGG 04153263025,6930.38,groceries
06-Feb-14,1700,,,TRANSFER CREDIT,INTERNET TRANSFER Rent R and J,6939.87,parents
06-Feb-14,3945,,,DEPOSIT,CASH AND/OR CHEQUES,5239.87,gifts
05-Feb-14,-110,,,EFTPOS DEBIT,EFTPOS 04/02 11:58 HOTEL LAUNCESTON PTY LAUNCESTON TAS,1294.87,holiday
05-Feb-14,-83.96,,,MISCELLANEOUS DEBIT,V1234 05/02 COLES EX PR BUNKER HILL VIC 12345674036,1404.87,holiday
05-Feb-14,-72,,,EFTPOS DEBIT,EFTPOS 04/02 19:30 BLACK COW BISTRO 70 GEORGE STREET,1488.83,holiday
05-Feb-14,-54.4,,,EFTPOS DEBIT,EFTPOS 05/02 09:56 CALTEX LAUNCESTON TAS 66061,1560.83,holiday
05-Feb-14,-19.4,,,MISCELLANEOUS DEBIT,V1234 05/02 KAMEO CO FFEE LOUNGE LAU NCESTON 74564454036,1615.23,holiday
04-Feb-14,-65,,,MISCELLANEOUS DEBIT,V1234 03/02 MAN O RO SS PL ROS S 74564454034,1634.63,holiday
04-Feb-14,-18.33,,,MISCELLANEOUS DEBIT,V1234 04/02 COLES L AUNCESTON TAS 12345674035,1699.63,holiday
04-Feb-14,-16.95,,,EFTPOS DEBIT,EFTPOS 04/02 13:12 CACTUS INVESTMENTS T AS LAUNCESTON AU,1717.96,holiday
03-Feb-14,-110,,,EFTPOS DEBIT,EFTPOS 03/02 16:26 TASMANIAN WOOL CENTR ROSS TAS,1734.91,holiday
03-Feb-14,-52,,,EFTPOS DEBIT,EFTPOS 02/02 15:23 HADLEY'S HOTEL HOBAR HOBART TA,1844.91,holiday
03-Feb-14,-44,,,MISCELLANEOUS DEBIT,V1234 01/02 ANNAPURN A RESTAURANTS P LHOB ART 74564454034,1896.91,holiday
03-Feb-14,-24.5,,,EFTPOS DEBIT,EFTPOS 03/02 09:54 MMELD Pty Ltd 95867 36 Hobart 07AU,1940.91,holiday
03-Feb-14,-15.5,,,MISCELLANEOUS DEBIT,V1234 01/02 SALAMANC A FOOD FAIR HOB ART 74940524033,1965.41,holiday
03-Feb-14,-6.39,,,MISCELLANEOUS DEBIT,V1234 01/02 CHEMIST WAREHOUSE HOB ART 06165521291,1980.91,holiday
03-Feb-14,-4.95,,,MISCELLANEOUS DEBIT,V1234 31/01 RIVERS H OBART HOB ART 05150643528,1987.3,holiday
31-Jan-14,-414,,,EFTPOS DEBIT,EFTPOS 31/01 09:25 YOUTH HOSTEL ASSOC OF TASMANIA HOBART,1992.25,holiday
31-Jan-14,-92,,,TRANSFER DEBIT,INTERNET TRANSFER 4368 Jacqui Williams,2406.25,holiday
31-Jan-14,-36.77,,,MISCELLANEOUS DEBIT,V1234 31/01 COLES N EWTOWN TAS 12345674030,2498.25,holiday
31-Jan-14,-18,,,MISCELLANEOUS DEBIT,V1234 31/01 BWS LIQU OR 7151 HOB ART 05180183134,2535.02,holiday
31-Jan-14,-14,,,MISCELLANEOUS DEBIT,V1234 31/01 KMART N EWTOWN TAS 12345674030,2553.02,holiday
30-Jan-14,-51,,,MISCELLANEOUS DEBIT,V1234 28/01 NSW REGI STRY OF BDM CHI PPENDAL 74564724029,2567.02,holiday
30-Jan-14,-30,,,EFTPOS DEBIT,EFTPOS 30/01 11:41 BRUNY ISLAND CHEESE GREAT BAY TA,2618.02,holiday
29-Jan-14,-300,,,ATM DEBIT,SML ATM 29th10:39 CASHCARD\ADVENTURE B,2648.02,holiday
29-Jan-14,-2.5,,,FEES,SML ATM 29th10:39 CASHCARD\ADVENTURE B DIR CHG OTH ATM,2948.02,holiday
29-Jan-14,1241.87,,,SALARY,4666424 ANU Michael Asher,2950.52,salary
28-Jan-14,-350,,,ATM DEBIT,BBL ATM 25th08:25 CPA-IGA Coles Bay,1708.65,holiday
28-Jan-14,-54.7,,,MISCELLANEOUS DEBIT,V1234 27/01 BENNETTS PETROLEUM SUPPLISNU G 74564454028,2058.65,holiday
28-Jan-14,-45,,,EFTPOS DEBIT,EFTPOS 25/01 20:46 TOMBOLO FREYCINET COLES BAY TAS,2113.35,holiday
28-Jan-14,-30.15,,,MISCELLANEOUS DEBIT,V1234 27/01 SORELL C OUNTRY FRESH SOR ELL 74940524027,2158.35,holiday
28-Jan-14,-19.95,,,MISCELLANEOUS DEBIT,V1234 25/01 COLES BA Y CONVENIENC COL ES BAY 74940524025,2188.5,holiday
28-Jan-14,-16.5,,,EFTPOS DEBIT,EFTPOS 24/01 14:55 FREYCINET LODGE COLES BAY TA,2208.45,holiday
28-Jan-14,-16.19,,,MISCELLANEOUS DEBIT,V1234 26/01 MRD SUPE RMARKETS PTY TRI ABUNNA 74940524026,2224.95,holiday
28-Jan-14,-2.5,,,FEES,BBL ATM 25th08:25 CPA-IGA Coles Bay DIR CHG OTH ATM,2241.14,holiday
28-Jan-14,-1.82,,,MISCELLANEOUS DEBIT,V1234 27/01 COLES S ORELL TAS 12345674027,2243.64,holiday
24-Jan-14,-56.5,,,EFTPOS DEBIT,EFTPOS 24/01 19:56 TOMBOLO FREYCINET COLES BAY TAS,2245.46,holiday
24-Jan-14,-31,,,EFTPOS DEBIT,EFTPOS 23/01 12:50 P.R WILSON & W.J WIL BICHENO TA,2301.96,holiday
24-Jan-14,41.9,,,MISCELLANEOUS CREDIT,V1234 24/01 ASOS SYD NEY 05095563536,2332.96,holiday
24-Jan-14,89.51,,,MISCELLANEOUS CREDIT,V1234 24/01 ASOS SYD NEY 05095713078,2291.06,holiday
23-Jan-14,-72.97,,,EFTPOS DEBIT,EFTPOS 22/01 09:59 BAYSIDE INN ST HELENS TAS,2201.55,holiday
23-Jan-14,-66,,,AUTOMATIC DRAWING,2000410934887 Telstra DDebit asher. m and j,2274.52,mobile
23-Jan-14,-49,,,EFTPOS DEBIT,EFTPOS 23/01 11:25 Bicheno Service18057 38 Bicheno 07AU,2340.52,holiday
23-Jan-14,-24,,,EFTPOS DEBIT,EFTPOS 23/01 14:13 DTAE 0001 COLES BAY,2389.52,holiday
23-Jan-14,-12.47,,,EFTPOS DEBIT,EFTPOS 23/01 13:02 BICHENO GENERAL STORE BICHENO TAS,2413.52,holiday
22-Jan-14,-20,,,EFTPOS DEBIT,EFTPOS 22/01 12:17 EAST COAST AUTO PART ST HELENS TAS,2425.99,holiday
22-Jan-14,-17,,,EFTPOS DEBIT,EFTPOS 22/01 11:15 MOHR & SMITH ST HELENS TAS,2445.99,holiday
22-Jan-14,-16.07,,,EFTPOS DEBIT,EFTPOS 22/01 11:59 ST HELENS SUPA IGA ST HELENS TAS,2462.99,holiday
21-Jan-14,-307.34,,,MISCELLANEOUS DEBIT,V1234 21/01 AUTO & G ENERAL INSURANCE TOO WONG 74564454021,2479.06,holiday
21-Jan-14,-127.5,,,MISCELLANEOUS DEBIT,V1234 19/01 MELBOURN E AIRPORT MEL BOURNE 74564504020,2786.4,holiday
21-Jan-14,-12.95,,,MISCELLANEOUS DEBIT,V1234 20/01 RAYS OUT DOORS LAU NCESTON 74564454020,2913.9,holiday
21-Jan-14,-8.87,,,MISCELLANEOUS DEBIT,V1234 20/01 AUSTRALI A POST 337586 MEL BOURNE 74940524020,2926.85,holiday
20-Jan-14,-156.77,,,MISCELLANEOUS DEBIT,V1234 20/01 COLES L AUNCESTON TAS 12345674020,2935.72,holiday
20-Jan-14,-114.25,,,MISCELLANEOUS DEBIT,V1234 20/01 KMART L AUNCESTON TAS 12345674020,3092.49,holiday
20-Jan-14,-37,,,MISCELLANEOUS DEBIT,V1234 17/01 MURRAYS AUSTRALIA PTY LTDRED HILL 74564454017,3206.74,holiday
20-Jan-14,-24.97,,,EFTPOS DEBIT,EFTPOS 18/01 10:16 THOMAS JEWELLERS WAGGA WAGGA NS,3243.74,holiday
20-Jan-14,-22.26,,,EFTPOS DEBIT,EFTPOS 20/01 16:33 YOUNG'S VEGIE SHED LAUNCESTON TA,3268.71,holiday
20-Jan-14,-9.55,,,EFTPOS DEBIT,EFTPOS 20/01 11:18 DELAWARE NORTH 0001 TULLAMARINE,3290.97,holiday
20-Jan-14,-4.5,,,MISCELLANEOUS DEBIT,V1234 20/01 COLES L AUNCESTON TAS 12345674020,3300.52,holiday
17-Jan-14,-340,,,EFTPOS DEBIT,EFTPOS 17/01 15:33 BOOTED OUT 0001 WAGGA WAGGA,3305.02,
17-Jan-14,-89.59,,,MISCELLANEOUS DEBIT,V1234 17/01 SILVALIT E FUEL STOP WAG GA WAGG 05171995711,3645.02,
17-Jan-14,-30,,,EFTPOS DEBIT,EFTPOS 17/01 09:34 PASSION HAIR & BEAUT WAGGA WAGGA NS,3734.61,
17-Jan-14,-3.8,,,MISCELLANEOUS DEBIT,V1234 17/01 WOOLWORT HS 1273 WAG GA WAGG 05151712757,3764.61,
16-Jan-14,-3000,,,TRANSFER DEBIT,INTERNET TRANSFER save Mikey,3768.41,transfer
16-Jan-14,-700,,,TRANSFER DEBIT,INTERNET TRANSFER asher wedding,6768.41,
16-Jan-14,-67.55,,,MISCELLANEOUS DEBIT,V1234 16/01 OFFICEWO RKS WAGGA WAGGA NSW 12345674016,7468.41,
16-Jan-14,-29.99,,,MISCELLANEOUS DEBIT,V1234 16/01 WOOLWORT HS 1273 WAG GA WAGG 04151291561,7535.96,
15-Jan-14,-24.9,,,EFTPOS DEBIT,EFTPOS 14/01 10:43 VALLEYGIRL WAGGA WAG WAGGA WAGGA NSW,7565.95,
15-Jan-14,1241.87,,,SALARY,4666424 ANU Michael Asher,7590.85,salary
14-Jan-14,-39,,,EFTPOS DEBIT,EFTPOS 13/01 14:11 THE REJECT SHOP 0242 WAGGA WAGGA NS,6348.98,
14-Jan-14,-20,,,ATM DEBIT,NABATM CSH 14th10:50 STURT MALL,6387.98,
14-Jan-14,-11.98,,,MISCELLANEOUS DEBIT,V1234 14/01 OFFICEWO RKS WAGGA WAGGA NSW 12345674014,6407.98,
14-Jan-14,-3,,,MISCELLANEOUS DEBIT,V1234 14/01 KMART W AGGA WAGGA NSW 12345674013,6419.96,
13-Jan-14,-510,,,EFTPOS DEBIT,EFTPOS 11/01 12:13 SCOOTER FLOWERS 11 GURWOOD ST,6422.96,
13-Jan-14,-96,,,MISCELLANEOUS DEBIT,V1234 13/01 WOW 1441 WAGGA WAG GA WAGG 01140102852,6932.96,
13-Jan-14,-45,,,EFTPOS DEBIT,EFTPOS 13/01 14:14 HONG HSIANG AUSTRALI WAGGA WAGGA NSW,7028.96,
13-Jan-14,-39.95,,,MISCELLANEOUS DEBIT,V1234 11/01 MYER WA GGA WAG GA WAGG 74564454013,7073.96,
13-Jan-14,-19.2,,,EFTPOS DEBIT,EFTPOS 12/01 12:14 THE POT N KETTLE COF WAGGA WAGGA NSW,7113.91,
13-Jan-14,-13.7,,,EFTPOS DEBIT,EFTPOS 13/01 09:42 THE BLESSED BEAN 0001 WAGGA WAGGA,7133.11,
13-Jan-14,-13,,,MISCELLANEOUS DEBIT,V1234 11/01 WOOLWORT HS 1273 WAG GA WAGG 06143820690,7146.81,
13-Jan-14,2100,,,DEPOSIT,CHEQUES,7159.81,
13-Jan-14,5000,,,TRANSFER CREDIT,INTERNET TRANSFER Wedding RA JM Williams,5059.81,
10-Jan-14,-238.98,,,EFTPOS DEBIT,EFTPOS 09/01 19:58 DICK SMITH 8196 \WAGGA WAGGA NSW AU,59.81,
10-Jan-14,-71.39,,,MISCELLANEOUS DEBIT,V1234 10/01 SPOTLIGH T WAGGA WA EAS T WAGGA 05145088857,298.79,
10-Jan-14,-18.86,,,MISCELLANEOUS DEBIT,V1234 10/01 WOOLWORT HS 1273 WAG GA WAGG 05090140202,370.18,
10-Jan-14,-0.5,,,MISCELLANEOUS DEBIT,V1234 10/01 COLES G LENFIELD PARK NSW 12345674010,389.04,
09-Jan-14,-27.83,,,MISCELLANEOUS DEBIT,V1234 09/01 WOOLWORT HS 1273 WAG GA WAGG 04172048222,389.54,
08-Jan-14,-50,,,MISCELLANEOUS DEBIT,V1234 07/01 ROAM TOL LING PTY LTD EAS TERN CR 74564724007,417.37,
08-Jan-14,-19.35,,,MISCELLANEOUS DEBIT,V1234 06/01 PAYPAL * GOPARTYSUPP 402 9357733 74245374007,467.37,
08-Jan-14,-10.59,,,MISCELLANEOUS DEBIT,V1234 08/01 COLES G LENFIELD PARK NSW 12345674008,486.72,
07-Jan-14,-24.96,,,MISCELLANEOUS DEBIT,V1234 07/01 WOOLWORT HS 1273 WAG GA WAGG 02172535516,497.31,
07-Jan-14,-24.8,,,EFTPOS DEBIT,EFTPOS 07/01 13:20 CACHE STORE OF FOOD 214 220 BAYLIS STREE,522.27,
06-Jan-14,-137.95,,,MISCELLANEOUS DEBIT,V1234 04/01 MYER WA GGA WAG GA WAGG 74564454006,547.07,
06-Jan-14,-125.7,,,MISCELLANEOUS DEBIT,V1234 05/01 ASOS SYD NEY 07103741495,685.02,
06-Jan-14,-16.65,,,MISCELLANEOUS DEBIT,V1234 04/01 WOOLWORT HS 1273 WAG GA WAGG 06202953199,810.72,
03-Jan-14,-2000,,,TRANSFER DEBIT,INTERNET TRANSFER Al Qaeda,827.37,
03-Jan-14,-20,,,ATM DEBIT,CBA ATM 03rd10:50 CBA ATM WAGGA WAGGA,2827.37,
03-Jan-14,-2,,,FEES,CBA ATM 03rd10:50 CBA ATM WAGGA WAGGA DIR CHG OTH ATM,2847.37,
02-Jan-14,-91.16,,,MISCELLANEOUS DEBIT,V1234 01/01 CALTEX GUM LY GUML 74940524001,2849.37,
02-Jan-14,-17.28,,,EFTPOS DEBIT,EFTPOS 01/01 13:38 APRINAMEL PTY LTD BUNGENDORE NSW,2940.53,
